2 13 31
###############################
#p  *  s* * 1  *      * * *   #
# # # # # # # # # # # #*#*#*# #
#   f     bb*     1           #
# # # # # # # # # # # # # # # #
#  *    s     **   *  *       #
# # # # # # # # # # # # # # # #
#*     *       *  *      *f   #
# # #   # # # # # # # # # # # #
#      **    *       *        #
# # #*# # # # # #*# # # # # # #
#    s    *     *      *   4  #
###############################