2 13 31
###############################
#p  *  s* * 1  *      * * *   #
# # # # # # # # # # # #*#*#*# #
#   f     bb*     1           #
# # # # # # # # # # # # # # # #
#  *    s     **   *  *       #
# # # # # # # # # # # # # # # #
#*     *   2   *  *      *f   #
# # #   # # # # # # # # # # # #
#      **    *       *     3  #
# # #*# # # # # #*# # # # # # #
#    s    *     *      *  4   #
###############################