2 13 31
###############################
#p  *  s* *    *  2   * * *   #
# # # # # # # # # # # #*#*#*# #
#   f     bb*          *      #
# # # # # # # # # # # # # # # #
#  *    s     **   *  *  3    #
# # # # # # # # # # # # # # # #
#*     *       *  *     *f   #
# # #   # # # # # # # # # # # #
#      **    *     5 *        #
# # #*# # # # # #*# # # # # # #
#    s    *     *      *      #
###############################